w,w,w,s,w,w,w,w,w,w
w,w,w,s,w,w,w,w,w,w
w,w,w,s,w,w,w,w,w,w
w,w,w,w,w,w,w,s,s,w
w,w,w,w,w,w,w,w,w,w
w,w,w,w,s,w,w,w,w,w
w,s,s,s,s,w,w,w,w,w
w,w,w,w,s,w,s,s,s,s
w,w,w,w,s,w,w,w,w,w
w,w,w,w,s,w,w,w,w,w
